##############
SS   ##SSSSSS#
#S## # S    S#
#S # SSS    S#
#S # S      S#
#SSSSS      S#
#        SSSS#
#        S   #
#        SSSS
##############
